++++++++
+0+    +
+ A+ ad+
+ + +  +
+  D + +
+ ++++ +
+      +
++++++++