++++++++++++++++++++++++++++++++++++++++++++++++++++++++++++++++++
+0A                                                              +
+                                                                +
+                                                                +
+                                                                +
+                                                                +
+                                                                +
+                                                                +
+                                                                +
+                                                                +
+                                                                +
+                                                                +
+                                                                +
+                                                                +
+                                                                +
+                                                                +
+                                                                +
+                                                                +
+                                                                +
+                                                                +
+                                                                +
+                                                                +
+                                                                +
+                                                                +
+                                                                +
+                                                                +
+                                                                +
+                                                                +
+                                                                +
+                                                                +
+                                                                +
+                                                                +
+                                                                +
+                                                                +
+                                                                +
+                                                                +
+                                                                +
+                                                                +
+                                                                +
+                                                                +
+                                                                +
+                                                                +
+                                                                +
+                                                                +
+                                                                +
+                                                                +
+                                                                +
+                                                                +
+                                                                +
+                                                                +
+                                                                +
+                                                                +
+                                                                +
+                                                                +
+                                                                +
+                                                                +
+                                                                +
+                                                                +
+                                                                +
+                                                                +
+                                                                +
+                                                                +
+                                                                +
+                                                                +
+                                                               a+
++++++++++++++++++++++++++++++++++++++++++++++++++++++++++++++++++
